woman that sleeps	UttNP (MassNP (RelCN (UseN woman_N) (UseRCl (TTAnt TPres ASimul) PPos (RelVP IdRP (UseV sleep_V)))))
woman who sleeps	UttCN (SentCN (UseN woman_N) (EmbedQS (UseQCl (TTAnt TPres ASimul) PPos (QuestVP whoSg_IP (UseV sleep_V)))))
woman who sleeps here	UttNP (MassNP (SentCN (UseN woman_N) (EmbedQS (UseQCl (TTAnt TPres ASimul) PPos (QuestVP whoSg_IP (AdvVP (UseV sleep_V) here_Adv))))))
woman that sleeps here	UttCN (AdvCN (RelCN (UseN woman_N) (UseRCl (TTAnt TPres ASimul) PPos (RelVP IdRP (UseV sleep_V)))) here_Adv
woman that is very old	UttCN (RelCN (UseN woman_N) (UseRCl (TTAnt TPres ASimul) PPos (RelVP IdRP (UseComp (CompAP (AdAP very_AdA (PositA old_A)))))))
woman that is old	UttCN (RelCN (UseN woman_N) (UseRCl (TTAnt TPres ASimul) PPos (RelVP IdRP (UseComp (CompAP (PositA old_A))))))
whom does she see 	UttQS (UseQCl (TTAnt TPres ASimul) PPos (QuestSlash whoPl_IP (SlashVP (UsePron she_Pron) (SlashV2a see_V2))))
because she sleeps	UttAdv (SubjS because_Subj (UseCl (TTAnt TPres ASimul) PPos (PredVP (UsePron she_Pron) (UseV sleep_V))))
between you and me	UttAdv (PrepNP between_Prep (ConjNP and_Conj (BaseNP (UsePron youPl_Pron) (UsePron i_Pron))))
both here and there	UttAdv (ConjAdv both7and_DConj (BaseAdv here_Adv there_Adv))
he works at the bank	PhrUtt NoPConj (UttS (UseCl (TTAnt TPres ASimul) PPos (PredVP (UsePron he_Pron) (AdvVP (UseV work_1_V) (PrepNP at_Prep (DetCN (DetQuant DefArt NumSg) (UseN bank_2_N))))))) NoVoc
he works every day	ChunkPhr (PlusChunk (S_Chunk (UseCl (TTAnt TPres ASimul) PPos (PredVP (UsePron he_Pron) (UseV work_1_V)))) (OneChunk (NP_Acc_Chunk (DetCN every_Det (UseN day_N)))))
she works with many people	PhrUtt NoPConj (UttS (UseCl (TTAnt TPres ASimul) PPos (PredVP (UsePron she_Pron) (AdvVP (UseV work_1_V) (PrepNP with_Prep (DetCN many_Det (UseN people_N))))))) NoVoc
my computer works perfectly	PhrUtt NoPConj (UttS (UseCl (TTAnt TPres ASimul) PPos (PredVP (DetCN (DetQuant (PossPron i_Pron) NumSg) (UseN computer_N)) (AdvVP (UseV work_2_V) (PositAdvAdj perfect_A))))) NoVoc
my computer works	PhrUtt NoPConj (UttS (UseCl (TTAnt TPres ASimul) PPos (PredVP (DetCN (DetQuant (PossPron i_Pron) NumSg) (UseN computer_N)) (UseV work_2_V)))) NoVoc
my computer doesn't work	PhrUtt NoPConj (UttS (UseCl (TTAnt TPres ASimul) PNeg (PredVP (DetCN (DetQuant (PossPron i_Pron) NumSg) (UseN computer_N)) (UseV work_2_V)))) NoVoc
I like sleep	PhrUtt NoPConj (UttS (UseCl (TTAnt TPres ASimul) PPos (PredVP (UsePron i_Pron) (ComplSlash (SlashV2a like_V2) (MassNP (UseN sleep_N)))))) NoVoc
I am sleeping	PhrUtt NoPConj (UttS (UseCl (TTAnt TPres ASimul) PPos (PredVP (UsePron i_Pron) (ProgrVP (UseV sleep_V))))) NoVoc
I am working	PhrUtt NoPConj (UttS (UseCl (TTAnt TPres ASimul) PPos (PredVP (UsePron i_Pron) (ProgrVP (UseV work_1_V))))) NoVoc
he is working	PhrUtt NoPConj (UttS (UseCl (TTAnt TPres ASimul) PPos (PredVP (UsePron he_Pron) (ProgrVP (UseV work_1_V))))) NoVoc
she is a little girl	PhrUtt NoPConj (UttS (UseCl (TTAnt TPres ASimul) PPos (PredVP (UsePron she_Pron) (UseComp (CompNP (DetCN (DetQuant IndefArt NumSg) (AdjCN (PositA little_A) (UseN girl_N)))))))) NoVoc
she is a girl	PhrUtt NoPConj (UttS (UseCl (TTAnt TPres ASimul) PPos (PredVP (UsePron she_Pron) (UseComp (CompNP (DetCN (DetQuant IndefArt NumSg) (UseN girl_N))))))) NoVoc
I play football	PhrUtt NoPConj (UttS (UseCl (TTAnt TPres ASimul) PPos (PredVP (UsePron i_Pron) (ComplSlash (SlashV2a play_1_V2) (MassNP (UseN football_N)))))) NoVoc
he plays the trumpet	PhrUtt NoPConj (UttS (UseCl (TTAnt TPres ASimul) PPos (PredVP (UsePron he_Pron) (ComplSlash (SlashV2a play_3_V2) (DetCN (DetQuant DefArt NumSg) (UseN trumpet_N)))))) NoVoc
the child plays with a doll	PhrUtt NoPConj (UttS (UseCl (TTAnt TPres ASimul) PPos (PredVP (DetCN (DetQuant DefArt NumSg) (UseN child_N)) (AdvVP (UseV play_2_V) (PrepNP with_Prep (DetCN (DetQuant IndefArt NumSg) (UseN doll_N))))))) NoVoc
the children play in the park	PhrUtt NoPConj (UttS (UseCl (TTAnt TPres ASimul) PPos (PredVP (DetCN (DetQuant DefArt NumPl) (UseN child_N)) (AdvVP (UseV play_2_V) (PrepNP in_Prep (DetCN (DetQuant DefArt NumSg) (UseN park_N))))))) NoVoc
the play is over soon	PhrUtt NoPConj (UttS (UseCl (TTAnt TPres ASimul) PPos (PredVP (DetCN (DetQuant DefArt NumSg) (UseN play_N)) (AdvVP (UseComp (CompAdv soon_Adv)) over_Adv)))) NoVoc